####################
# a  000          f#
# a   00  ########e#
# a      ###000#####
# #         EEE b###00000000000000###
# #AAAAAAAA#########00000000000000#Z##
# ##    c   a#######00000000000000#  #
# ##   cdc  aDC  B##00000000#######  #
# ###   c   aDC  B###########   F    #
#S####      aDC  B   A   C  E  #######
########a######  ############ ##
#abcdef           #000000000# #
#                 #000000000# #
#ABCDEF           #000000000#f#
###################000000000###