#####
##Z##
##2##
##C##
##3##
##b##
##B##
##5##
##a##
##e##
##D##
##E##
##d##
##4##
##C##
##1##
##e##
##d##
##c##
##b##
##a##
##S##
#####