#############
##000000#a ##
##000000#RR#########
#########RR#########
##     mm   mrr   ##
## S   MM f mrr  Z##
####   #############
#### a #############
#########
#########