##############
#       c d  ######
# ##   a c   DCe B#
# ###   c    DC  B#
#S####        a  B#
########EE       ##
#abcdef  E       #
#ZABCDEF E      #
################